8 6 1 

01 00 00 00 00 02 02 03 
01 02 02 02 02 05 05 05 
04 05 05 05 05 05 08 09 
07 08 08 08 08 08 08 09 
07 08 08 08 08 08 08 09 
10 11 11 11 11 11 11 12 

00 00 00 00 00 00 00 00 
00 00 00 00 00 00 00 00 
00 00 00 00 00 00 01 01 
01 01 01 01 01 01 01 01 
01 01 01 01 01 01 01 01 
01 01 01 01 01 01 01 01 
